{
  "theme": "plain",
  "layers": [
    [
      "                    ",
      "                    ",
      "                    ",
      "                    ",
      "                    ",
      "                    ",
      "                    ",
      "                    ",
      "                    ",
      " 0                  ",
      "::  8             ::",
      "                    ",
      "    ::::::::::::    ",
      "                    ",
      "                    "
    ]
  ]
}
