{
  "theme": "plain",
  "layers": [
    [
      "      |                                |||      ",
      "      |                                  |      ",
      "      |             |||                  |      ",
      "      |      ~~~    |||                  |      ",
      "      |             |||                  |      ",
      "      |     :::::                        |      ",
      "      |                           |||||: |      ",
      "      |                           |   |  |      ",
      "      |                  ~~~~~    |   | :|||||||",
      "      |           ~~              |   |4 |      ",
      "      |                           |   |: |      ",
      "      |                 :::::::   |   |         ",
      "      |           3               |   |         ",
      "      |:::|:::::::| |:::::   :::::|   |:::::::::",
      "          |~~~      |             |             ",
      "          |         |  :::::::::  |             ",
      "         2|?      | |  4  4   4  4|             ",
      " 0    |:::|:::::::| |||||||||||||||             ",
      "::::::|           | |                           ",
      "      |           | |                           ",
      "      |           | |                           "
    ]
  ]
}