{
  "theme": "plain",
  "layers": [
    [
      "                            |                        ",
      "                            |                        ",
      "                            |                        ",
      "                  ~~~       |                        ",
      "                       |:: ~|                        ",
      "                       |   ~|                        ",
      "                      2|   ~|                        ",
      "              :::|:::::|   ~|                        ",
      "                 |     |    |                        ",
      "                 |     |    |    x         4 ?       ",
      "                3|     |   4|    |      |:::|F|::::::",
      "            :::::|     |  ::|    |     1|   |F|      ",
      "                 |     |~        |::::::|   |F|      ",
      " 0              1|     |~        |          |F|      ",
      ":::::|   |:::::::|     |~        |          |F|      ",
      "     |   |             |~   |::::|          |F|      ",
      "     |   |             |    |               |F|      ",
      "     |   |             |    |               :::      ",
      "     |   |             |    |                        "
    ]
  ]
}
