{
  "theme": "plain",
  "layers": [
    [
      "                                                         ",
      "                                                         ",
      "                      |                                  ",
      "                      |                                  ",
      "                      |      ~~~~                        ",
      "         ~~~~         |                                  ",
      "                   |  | ::|                          ~~~ ",
      "     |:            |      |        ::::::    ~~~~        ",
      "     |         :|::|xxxxxx|xxxxxxxxxx    :               ",
      "  0  ||||xxxxxxx|  |::::::|::::::::::     :         :::::",
      ":::::||||||||||||                    xxxxxxxxxxxxxx      ",
      "     |          |                    ::::::::::::::xxxxxx",
      "     |          |                                  ::::::",
      "     |          |                                        ",
      "     |          |                                        "
    ]
  ]
}
