{
  "theme": "plain",
  "layers": [
    [
      "      |            |       |             ",
      "      |            |       |             ",
      "      |            |       |             ",
      "      |            |       |  3  |       ",
      "      |    |::::  ~|       |:::  |       ",
      "      |3   |      ~|             |  ~    ",
      "      |::  |      ~|         ~~~ |  ~    ",
      "      |    |      ~|             |  ~    ",
      "      |    |       |            2|  ~    ",
      "      |    |~  |   |        :::::|  ~    ",
      "      |3   |~  |xxx|             |       ",
      "      |::  |~  |||||         13  |       ",
      "           |~            |::::|  ||||||||",
      "           |~           ||    |  |       ",
      " 0         |~   ~~~~   | |    |  |       ",
      ":::::::::::|         1|  |    |          ",
      "           |   |:::::|   |    |     ?    ",
      "           |xxx|         |    |  ::::::  ",
      "           |||||         |    |          ",
      "           |             |    |          "
    ]
  ]
}
