{
  "theme": "plain",
  "layers": [
    [
      "                                                                    ",
      "                                                                    ",
      "                                                                    ",
      "                      |                                             ",
      "                      |      ~~~~                                   ",
      "         ~~~~         |                                             ",
      "                   |  | ::|                          ~~~            ",
      "     |:            |      |        ::::::    ~~~~                   ",
      "     |         :|::|xxxxxx|xxxxxxxxxx    :                          ",
      "  0  |xxxxxxxxxx|  |::::::|::::::::::     :         :::::           ",
      ":::::||||||||||||                    xxxxxxxxxxxxxx                 ",
      "     |          |                    ::::::::::::::xxxxxxxxxxxxxxxxx",
      "     |          |                                  :::::::::::::::::",
      "     |          |                                                   ",
      "     |          |                                                   "
    ]
  ]
}
