{
  "theme": "plain",
  "name": "チューリップ農園",
  "engName": "Tulip Plantation",
  "bgm": "bgm1",
  "layers": [
    [
      "                     ~                                   ",
      "                    ~ ~                  ~~~~            ",
      "                             ~~~~   ~~~~                 ",
      "                                             ?           ",
      "           ~~~ :::::   ::::|     ||     ::::::           ",
      "                           |                             ",
      "                           |                             ",
      "        ::||||||||         |              ~~~           3",
      "        ~~|                |       ~~               :::::",
      "          |                |                3            ",
      "      ::::|                |         3   |::::      3    ",
      "      ~~~~|                |      ::::   |      :::::    ",
      "          |                |             |               ",
      "    ::::::|                |  1 1  1  1  |      3        ",
      "          |                |||||||||||||||||||||||       ",
      " 0       2|                                              ",
      "|||||||||||                                              ",
      "|                                                        ",
      "|                                                        "
    ]
  ]
}