{
  "theme": "plain",
  "layers": [
    [
      "        |                        |    ",
      "        |                        |    ",
      "        |                        |    ",
      "        |                        |    ",
      "        |                        |    ",
      "        |                3       |    ",
      "        |           |:::::       |    ",
      "        |  |:::::|  |            |    ",
      "        |  | ?      |         3  |    ",
      "        |  ||::::|  |   ::::::||||    ",
      "        |  |        |         |       ",
      "        |  |        |         |       ",
      "        |  |        |     3   |       ",
      "           |        ||||||||  |       ",
      "           |                          ",
      "           |                          ",
      "        |  |                          ",
      "        |  |               :::::::::::",
      " 0      |  |                          ",
      ":::::   |  |                          ",
      "        |  |                          ",
      "        |  |                          ",
      "        |  |                          ",
      "                                      ",
      "                                      ",
      "                                      "
    ]
  ]
}