{
  "theme": "plain",
  "layers": [
    [
      "       |                        ",
      "       |       ~~~~             ",
      "       |           2            ",
      "       |      |::::|            ",
      "       |      |    |            ",
      "       |      |   1|            ",
      "       |      |xxxx|  3         ",
      "       |  ::::||||||::::|       ",
      "       |                |    3  ",
      "       | ~~~~           |:::::::",
      "       |                |       ",
      "|||||||||||||             ?     ",
      "            |:::  |   :::::::   ",
      "            |     |             ",
      "            |   ~~|             ",
      "|||||||||||||     |             ",
      "                ::|             ",
      "               ~~~|             ",
      " 0                |             ",
      "::::::|       ::::|             ",
      "      |           |             ",
      "      |   3   3   |             ",
      "       :::::::::::|             ",
      "                                ",
      "                                "
    ]
  ]
}
