{
  "theme": "plain",
  "layers": [
    [
      "                     ~                                      ",
      "                    ~ ~                 ~~~~                ",
      "                             ~~~~                           ",
      "                                            ?               ",
      "           ~~~ :::::   ::::|     |     ::::::               ",
      "                           |                                ",
      "                           |                                ",
      "        ::||||||||         |              ~~~           3   ",
      "        ~~|                |       ~~               :::::   ",
      "          |                |                3               ",
      "      ::::|                |         3   |::::      3       ",
      "      ~~~~|                |      ::::   |      :::::       ",
      "          |                |             |                  ",
      "    ::::::|                |  1 1  1  1  |      3           ",
      "          |                |||||||||||||||||||||||          ",
      " 0       2|                                                 ",
      "|||||||||||                                                 ",
      "|                                                           ",
      "|                                                           "
    ]
  ]
}
